##########
#  *****S#
###*## ###
###*## ###
###*##  ##
# #*### ##
# #F###  #
# # ##  ##
#      ###
##########
