##########
#       S#
### ## ###
### ## ###
### ##  ##
# # ### ##
# #F###  #
# # ##  ##
#      ###
##########