###############
####         S#
# ## ##### # ##
# ## # ### #  #
#    # ##### ##
# ## #       ##
# ## ##########
# ##    # ## ##
# ## ##   ## ##
# ## ####    ##
#  #   ## ## ##
#### #### ## ##
# ## ##F  ## ##
###############